preguntas_ciencia:		.asciz "¿Como se llama el componente minimo que forma a los seres vivos?", "Unidad basica de la materia", "La  columna más a la derecha de la tabla periódica esta compuesta por", " ¿Que elemento tiene el simbolo Cu?", " Ciencia que estudia los seres vivos", "La velocidad a la que viaja la luz es"
respuestas_ciencia:		.asciz  "b", "a", "b", "a", "c", "b"
aleatorios1_ciencia:	.asciz "a. Tejido", "b. Celula", "c. Particula"
aleatorios2_ciencia:	.asciz "a. Atomo", "b. Celula", "c. Mitocondria"
aleatorios3_ciencia:	.asciz "a. Haluros", "b. Gases nobles", "c. Minerales"
aleatorios4_ciencia:	.asciz "a. Cobre", "b. Carbon", "c. Calcio"
aleatorios5_ciencia:	.asciz "a. Viviologia", "b. Organismologia", "c. Biologia"
aleatorios6_ciencia:	.asciz "a. 300,000 m/s", "b. 300,000 km/s", "c. 30,000 km/h"

preguntas_literatura:	.asciz "¿Quien escribio 'La Iliada'?", "¿Quien es el autor de la 'Divina comedia'?", "¿Que autor NO pertenece al boom latinoamericano?", "Obra literaria mas vendida de la historia", "Autor que escribe en el genero de terror", "¿Cual de los autores SI pertenece al genero del realismo magico y es guatemalteco?"
respuestas_literatura:	.asciz "a", "c", "b", "c", "a", "c"
aleatorios1_literatura:	.asciz "a. Homero", "b. Herodoto", "c. Seneca"
aleatorios2_literatura:	.asciz "a. Petrarca", "b. Virgilio", "c. Dante Alighieri"
aleatorios3_literatura:	.asciz "a. Julio Cortazar", "b. Ruben Dario", "c. Gabriel Garcia Marquez"
aleatorios4_literatura:	.asciz "a. El Hobbit", "b. El senor de los Anillos", "c. Don Quijote de la Mancha"
aleatorios5_literatura:	.asciz "a. Stephen King", "b. JK Rowling", "c. William Shakespeare"
aleatorios6_literatura:	.asciz "a. Frida Kahlo", "b. Gabriel Garcia Marquez", "c. Miguel Angel Asturias"

preguntas_geografia:	.asciz "Continente con la mayor cantidad de paises", "Pais mas grande del mundo", "¿De qué tiene forma Italia?", "Pais con la mayor poblacion del mundo", "¿Donde se encuentra el rio mas grande de Africa?", "¿Cual de los siguientes es el lago mas grande del mundo?"
respuestas_geografia:	.asciz "a", "b", "c", "a", "b", "c"
aleatorios1_geografia:	.asciz "a. Africa", "b. Europa", "c. Asia"
aleatorios2_geografia:	.asciz "a. China", "b. Rusia", "c. Canada"
aleatorios3_geografia:	.asciz "a. Camisa", "b. Sombrero", "c. Bota"
aleatorios4_geografia:	.asciz "a. China", "b. India", "c. Brasil"
aleatorios5_geografia:	.asciz "a. Argelia", "b. Egipto", "c. Madagascar"
aleatorios6_geografia:	.asciz "a. Mar Rojo", "b. Mar Mediterraneo", "c. Mar Caspio"

preguntas_arte:	.asciz "¿A que movimiento pertenecio Pablo Picasso?", "Artista que se corto su propia oreja", "Artista y miembro de las tortugas ninja", "¿Cual era el 6o nombre de Picasso?", "¿Quien fue el primer arquitecto encargado de 'La Sagrada Familia'?", "¿Cual de estos era inventor a parte de ser artista?"
respuestas_arte:	.asciz "a", "c", "b", "c", "b", "c"
aleatorios1_arte:	.asciz "a. Cubismo", "b. Surrealismo", "c. Realismo"
aleatorios2_arte:	.asciz "a. Donatello", "b. Leonardo", "c. Vincent Van Gogh"
aleatorios3_arte:	.asciz "a. Claude Monet", "b. Miguel Angel", "c. Leonardo Da Vinci"
aleatorios4_arte:	.asciz "a. Juan", "b. Francisco de Paula", "c. Nepomuceno"
aleatorios5_arte:	.asciz "a. Francisco del Villar", "b. Antonio Gaudi", "c. Juan Rubio"
aleatorios6_arte:	.asciz "a. Dali", "b. Duchamp", "c. Da Vinci"

preguntas_historia:	.asciz "¿Cuantas veces fue apunalado el emperador Julio Cesar?", "¿Donde se asento la primera civilizacion?", "Lugar donde cruzan los humanos a América", "Ciudad destruida por la erupcion del Monte Vesuvio", "Caracteristica geografica donde se asientan las civilizaciones", "¿Quien estaba al mando del mayor imperio en la historia?"
respuestas_historia:	.asciz "a", "b", "a", "c", "a", "a"
aleatorios1_historia:	.asciz "a. 23", "b. 21", "c. 24"
aleatorios2_historia:	.asciz "a. Rio Nilo", "b. Mesopotamia", "c. Amazonas"
aleatorios3_historia:	.asciz "a. Estrecho de Bering", "b. Estrecho de Gibraltar", "c. Estrecho de Malaca"
aleatorios4_historia:	.asciz "a. Troya", "b. Atenas", "c. Pompeya"
aleatorios5_historia:	.asciz "a. Rios", "b. Montanas", "c. Playas"
aleatorios6_historia:	.asciz "a. La corona inglesa", "b. Genghis Khan", "c. Alejandro el Grande"

preguntas_deportes:	.asciz "¿Que pelicula de la triologia del Senor de los Anillos gano todos los oscares a los cuales fue nominada?", "Artista mas vendido de la historia", "¿Cual es el videojuego mas vendido de la historia?", "¿Cual es el deporte mas visto en las olimpiadas?", "¿Cual es el pais con mayor cantidad de mundiales?", "¿Cuantos kilometros se recorren en el Tour de Francia?"
respuestas_deportes:	.asciz "c", "a", "b", "c", "a", "b"
aleatorios1_deportes:	.asciz "a. La Comunidad del Anillo", "b. Las Dos Torres", "c. El Retorno del Rey"
aleatorios2_deportes:	.asciz "a. Elvis Presley", "b. Michael Jackson", "c. Elton John"
aleatorios3_deportes:	.asciz "a. Tetris", "b. Minecraft", "c. GTAV"
aleatorios4_deportes:	.asciz "a. Natacion", "b. Atletismo", "c. Gimnasia"
aleatorios5_deportes:	.asciz "a. Brasil", "b. Alemania", "c. Italia"
aleatorios6_deportes:	.asciz "a. 5600", "b. 5500", "c. 5700"